//MAP CONVERTED BY dmm2tgm.py THIS HEADER COMMENT PREVENTS RECONVERSION, DO NOT REMOVE
"a" = (
/turf/open/genturf/blue,
/area/planet/mission/surface/mission/rocky)
"v" = (
/turf/closed/indestructible/rock,
/area/icemoon/underground/explored)
"w" = (
/obj/missionmarker/mission,
/turf/open/genturf,
/area/planet/mission/surface/mission/rocky/safe)
"x" = (
/turf/open/genturf/orange,
/area/planet/mission/surface/mission/rocky/objective)
"E" = (
/turf/open/genturf,
/area/planet/mission/surface/mission/rocky/safe)

(1,1,1) = {"
v
v
v
v
v
v
v
v
v
v
v
v
v
v
v
v
v
v
v
v
"}
(2,1,1) = {"
v
x
x
x
a
a
a
a
a
a
a
a
a
E
E
E
E
E
E
v
"}
(3,1,1) = {"
v
x
x
x
a
a
a
a
a
a
a
a
a
E
E
E
E
E
E
v
"}
(4,1,1) = {"
v
x
x
x
a
a
a
a
a
a
a
a
a
E
E
E
E
E
E
v
"}
(5,1,1) = {"
v
x
x
x
a
a
a
a
a
a
a
a
a
E
E
E
w
E
E
v
"}
(6,1,1) = {"
v
x
x
x
a
a
a
a
a
a
a
a
a
E
E
E
E
E
E
v
"}
(7,1,1) = {"
v
x
x
x
a
a
a
a
a
a
a
a
a
E
E
E
E
E
E
v
"}
(8,1,1) = {"
v
x
x
x
a
a
a
a
a
a
a
a
a
E
E
E
E
E
E
v
"}
(9,1,1) = {"
v
x
x
x
a
a
a
a
a
a
a
a
a
E
E
E
E
E
E
v
"}
(10,1,1) = {"
v
x
x
x
a
a
a
a
a
a
a
a
a
a
a
a
a
a
a
v
"}
(11,1,1) = {"
v
x
x
x
a
a
a
a
a
a
a
a
a
a
a
a
a
a
a
v
"}
(12,1,1) = {"
v
x
x
x
a
a
a
a
a
a
a
a
a
a
a
a
a
a
a
v
"}
(13,1,1) = {"
v
x
x
x
a
a
a
a
a
a
a
a
a
a
a
a
a
a
a
v
"}
(14,1,1) = {"
v
x
x
x
a
a
a
a
a
a
a
a
a
a
a
a
a
a
a
v
"}
(15,1,1) = {"
v
x
x
x
a
a
a
a
a
a
a
a
a
a
a
a
a
a
a
v
"}
(16,1,1) = {"
v
x
x
x
a
a
a
a
a
a
a
a
a
a
a
a
a
a
a
v
"}
(17,1,1) = {"
v
x
x
x
x
x
x
x
x
x
x
x
x
x
x
x
x
x
x
v
"}
(18,1,1) = {"
v
x
x
x
x
x
x
x
x
x
x
x
x
x
x
x
x
x
x
v
"}
(19,1,1) = {"
v
x
x
x
x
x
x
x
x
x
x
x
x
x
x
x
x
x
x
v
"}
(20,1,1) = {"
v
v
v
v
v
v
v
v
v
v
v
v
v
v
v
v
v
v
v
v
"}
