//MAP CONVERTED BY dmm2tgm.py THIS HEADER COMMENT PREVENTS RECONVERSION, DO NOT REMOVE
"a" = (
/turf/open/floor/plating,
/area/planet/mission/surface/mission)
"c" = (
/obj/effect/dungeongen/helper/dungeon_monster_spawn,
/turf/open/floor/plating,
/area/planet/mission/surface/mission)
"U" = (
/turf/closed/wall,
/area/planet/mission/surface/mission)

(1,1,1) = {"
a
a
a
a
a
a
a
a
a
a
a
a
a
a
a
a
a
a
a
a
a
a
a
a
a
a
a
a
a
a
a
"}
(2,1,1) = {"
a
U
U
U
U
U
U
U
U
U
a
a
a
a
a
a
a
a
a
a
a
a
a
a
a
a
a
a
a
a
a
"}
(3,1,1) = {"
a
U
a
a
a
a
a
a
a
U
a
a
a
a
a
a
a
a
a
a
a
a
a
a
a
a
a
a
a
a
a
"}
(4,1,1) = {"
a
U
a
a
a
c
a
a
a
U
a
a
a
U
a
a
a
U
a
a
a
U
a
U
U
U
U
U
U
a
a
"}
(5,1,1) = {"
a
U
a
a
a
a
a
a
a
U
a
a
a
U
a
a
a
U
a
a
a
U
a
a
a
a
a
a
U
a
a
"}
(6,1,1) = {"
a
U
a
a
a
a
a
a
a
U
a
a
a
U
a
a
a
U
a
a
a
U
a
a
a
a
a
a
U
a
a
"}
(7,1,1) = {"
a
U
a
a
a
a
a
a
a
U
a
a
a
U
a
a
a
U
a
a
a
U
a
a
a
a
a
a
U
a
a
"}
(8,1,1) = {"
a
U
U
U
U
U
U
U
a
U
a
a
a
U
a
a
a
U
a
a
a
U
a
a
c
a
a
a
U
a
a
"}
(9,1,1) = {"
a
a
a
a
a
a
a
a
a
a
a
a
a
U
c
a
a
U
a
a
a
U
a
a
a
a
a
a
U
a
a
"}
(10,1,1) = {"
a
a
a
a
a
a
a
a
a
c
a
a
a
U
a
a
a
U
a
a
a
U
a
a
a
a
a
a
U
a
a
"}
(11,1,1) = {"
a
a
a
a
a
a
a
a
a
a
a
a
a
U
a
a
a
U
a
a
a
U
a
a
a
a
a
a
U
a
a
"}
(12,1,1) = {"
a
a
a
a
a
a
a
a
a
a
a
a
a
U
a
a
a
U
a
a
a
U
U
U
U
U
U
U
U
a
a
"}
(13,1,1) = {"
a
a
a
a
a
a
a
a
a
a
a
a
a
U
a
a
a
U
a
c
a
a
a
a
a
a
a
a
a
a
a
"}
(14,1,1) = {"
a
a
a
a
a
a
a
a
a
a
a
a
a
U
a
a
a
U
a
a
a
a
a
a
a
a
a
a
a
c
a
"}
(15,1,1) = {"
a
a
a
a
a
a
a
a
a
a
a
a
a
U
a
a
a
U
a
a
a
U
U
U
U
U
U
U
a
a
a
"}
(16,1,1) = {"
a
a
a
a
a
U
U
U
U
U
a
U
a
U
a
a
a
U
a
a
a
U
a
a
a
a
a
U
a
a
a
"}
(17,1,1) = {"
a
a
a
a
a
U
a
a
a
a
a
U
a
a
a
a
a
a
a
a
a
U
c
a
U
a
a
U
a
a
a
"}
(18,1,1) = {"
a
a
a
a
a
U
a
a
a
a
a
U
a
a
a
a
a
a
a
a
a
U
a
a
U
a
c
U
a
a
a
"}
(19,1,1) = {"
a
a
a
a
a
U
a
a
c
a
a
U
a
a
a
a
a
a
a
a
a
a
a
a
U
a
a
U
a
a
a
"}
(20,1,1) = {"
a
a
a
a
a
U
a
a
a
a
a
U
a
a
a
a
a
a
a
a
a
U
U
U
U
a
a
U
a
a
a
"}
(21,1,1) = {"
a
a
a
a
a
U
a
a
a
a
a
U
a
a
U
U
U
U
U
U
a
a
a
a
U
U
U
U
a
a
a
"}
(22,1,1) = {"
a
a
a
a
a
U
U
U
U
U
U
U
a
a
a
a
a
a
a
U
a
a
a
a
a
a
a
a
a
a
a
"}
(23,1,1) = {"
a
a
a
a
a
a
a
a
a
a
a
a
a
a
U
a
a
a
a
U
a
a
a
a
a
a
a
a
a
a
a
"}
(24,1,1) = {"
a
a
a
a
a
a
a
a
a
a
a
c
a
a
U
a
a
c
a
U
a
a
U
U
U
U
U
U
a
U
a
"}
(25,1,1) = {"
a
a
a
a
a
a
a
a
a
a
a
a
a
a
U
a
a
a
a
U
a
a
U
a
a
a
a
a
a
U
a
"}
(26,1,1) = {"
a
a
a
a
a
a
a
a
a
a
a
a
a
a
U
U
U
U
U
U
a
a
U
a
a
a
a
a
a
U
a
"}
(27,1,1) = {"
a
a
a
a
a
a
a
a
a
a
a
a
a
a
a
a
a
a
a
a
a
a
U
a
a
c
a
a
a
U
a
"}
(28,1,1) = {"
a
a
a
a
a
c
a
a
a
a
a
a
a
a
a
a
a
a
a
a
a
a
U
a
a
a
a
a
a
U
a
"}
(29,1,1) = {"
a
a
a
a
a
a
a
a
a
a
a
a
a
a
a
a
a
a
a
a
a
a
U
U
U
U
U
U
U
U
a
"}
(30,1,1) = {"
a
a
a
a
a
a
a
a
a
a
a
a
a
a
a
a
a
a
a
a
a
a
a
a
a
a
a
a
a
a
a
"}
(31,1,1) = {"
a
a
a
a
a
a
a
a
a
a
a
a
a
a
a
a
a
a
a
a
a
a
a
a
a
a
a
a
a
a
a
"}
