//MAP CONVERTED BY dmm2tgm.py THIS HEADER COMMENT PREVENTS RECONVERSION, DO NOT REMOVE
"a" = (
/turf/open/floor/plating,
/area/planet/mission/surface/mission)
"t" = (
/obj/effect/dungeongen/helper/dungeon_monster_spawn,
/turf/open/floor/plating,
/area/planet/mission/surface/mission)
"u" = (
/obj/missionmarker/mission,
/turf/open/floor/plating,
/area/planet/mission/surface/mission)
"S" = (
/turf/closed/wall,
/area/planet/mission/surface/mission)

(1,1,1) = {"
a
a
a
a
a
a
a
a
a
a
a
a
a
a
a
"}
(2,1,1) = {"
a
a
a
a
a
a
a
a
a
a
a
t
a
a
a
"}
(3,1,1) = {"
a
a
S
S
S
S
S
S
a
a
a
a
a
a
a
"}
(4,1,1) = {"
a
a
S
a
a
a
a
S
a
a
a
a
a
a
a
"}
(5,1,1) = {"
a
a
S
a
a
a
a
a
a
a
a
a
a
a
a
"}
(6,1,1) = {"
a
a
S
a
u
a
a
S
a
a
a
a
a
a
a
"}
(7,1,1) = {"
a
a
S
a
a
a
a
S
a
a
a
a
a
a
a
"}
(8,1,1) = {"
a
a
S
S
S
S
S
S
a
a
a
a
a
a
a
"}
(9,1,1) = {"
a
a
a
a
a
a
a
a
a
a
a
a
a
t
a
"}
(10,1,1) = {"
a
a
a
a
a
a
a
a
a
a
a
a
a
a
a
"}
(11,1,1) = {"
a
a
a
a
a
a
a
a
a
a
a
a
a
a
a
"}
(12,1,1) = {"
a
a
a
a
a
a
a
a
a
a
a
a
a
a
a
"}
(13,1,1) = {"
a
a
a
a
t
a
a
a
a
a
a
a
a
a
a
"}
(14,1,1) = {"
a
a
a
a
a
a
a
a
a
a
a
a
a
a
a
"}
(15,1,1) = {"
a
a
a
a
a
a
a
a
a
a
a
a
a
a
a
"}
