//MAP CONVERTED BY dmm2tgm.py THIS HEADER COMMENT PREVENTS RECONVERSION, DO NOT REMOVE
"a" = (
/turf/open/floor/plating,
/area/planet/mission/surface/mission)
"f" = (
/obj/machinery/door/airlock/engineering,
/turf/open/floor/plating,
/area/planet/mission/surface/mission)
"h" = (
/obj/machinery/door/airlock/glass,
/turf/open/floor/plating,
/area/planet/mission/surface/mission)
"l" = (
/obj/machinery/door/airlock/medical/glass,
/turf/open/floor/plating,
/area/planet/mission/surface/mission)
"I" = (
/obj/machinery/door/airlock/medical,
/turf/open/floor/plating,
/area/planet/mission/surface/mission)
"N" = (
/turf/closed/wall,
/area/planet/mission/surface/mission)
"T" = (
/obj/effect/dungeongen/helper/dungeon_monster_spawn,
/turf/open/floor/plating,
/area/planet/mission/surface/mission)

(1,1,1) = {"
a
a
a
a
a
a
a
a
a
a
a
a
a
a
a
"}
(2,1,1) = {"
a
N
N
N
N
N
N
N
N
a
N
N
N
N
a
"}
(3,1,1) = {"
a
N
a
a
I
a
a
a
N
a
N
a
a
N
a
"}
(4,1,1) = {"
a
N
T
a
N
a
T
a
N
a
N
T
a
N
a
"}
(5,1,1) = {"
a
N
a
T
N
T
a
a
N
a
N
h
N
N
a
"}
(6,1,1) = {"
a
N
a
T
N
a
a
a
l
a
a
a
a
a
a
"}
(7,1,1) = {"
a
N
N
N
N
N
N
N
N
a
a
a
a
a
a
"}
(8,1,1) = {"
a
a
a
a
a
a
a
a
a
a
a
a
a
a
a
"}
(9,1,1) = {"
a
a
a
a
a
a
a
a
a
a
a
T
a
a
a
"}
(10,1,1) = {"
a
a
a
a
a
a
a
a
a
a
a
a
a
a
a
"}
(11,1,1) = {"
a
a
a
a
a
a
a
N
N
f
N
a
a
a
a
"}
(12,1,1) = {"
a
a
a
a
T
a
a
N
a
a
N
a
a
a
a
"}
(13,1,1) = {"
a
a
T
a
a
a
a
N
a
T
N
a
a
a
a
"}
(14,1,1) = {"
a
a
a
a
a
a
a
N
N
N
N
a
a
a
a
"}
(15,1,1) = {"
a
a
a
a
a
a
a
a
a
a
a
a
a
a
a
"}
